#########################################
#...#.........#...........#...#...#.....#
#.#.#.#####.#.#.#######.#.###.#.#.#.###.#
#.#.#.....#.#.#.#.#.....#...#...#.....#.#
#.#######.#.###.#.#.#######.#####.#####.#
#.#.....#.#...#...#.......#.....#...#...#
#.#.#.###.###.###.#######.#####.###.#.###
#.#.#.....#.....#.......#.#...#.#...#...#
#.#.#######.###.#######.#.###.#.#######.#
#.#.#.#.....#...#...#...#...#...#.....#.#
#.#.#.#.#####.#####.#.#####.#.###.###.#.#
#.#.#.#.....#.......#...#.#.#...#.#.....#
#.#.#.#####.###.#######.#.#.###.#.#####.#
#.#...#...#...#.#.....#.#.#.#...#...#.#.#
#.###.###.###.###.#.###.#.#.###.###.#.#.#
#...#.......#.....#.......#...#.....#.#.#
#.#.#######.#########.#######.#######.#.#
#.#...#.....#.......#...#.....#.....#...#
#.###.#.#####.#####.#####.#######.#.#.###
#.#...#...#...#...#...#...#...#...#.#...#
#.###.#.###.###.#.###.#.###.#.#.#######.#
#...#.#.#...#...#...#.#.....#.#.#...#...#
#.#.###.#.###.###.###########.#.#.#.#.###
#.#.....#.#.#...#.............#...#.#...#
#.#######.#.#.#######.#########.###.###.#
#...#...#.#...#...#...#.#...#...#...#...#
###.#.#.#.#.###.#.#.###.#.#.#.###.#.#.###
#...#.#.#.#...#.#.#.#...#.#.#.#...#.#...#
#.###.###.#####.#.#.#.#.#.#.#.#.#######.#
#...#...#...#...#...#.#.#.#.#.#.......#.#
###.###.###.#.#########.#.#.#.#######.#.#
#.#.....#.#.#.#...#...#...#.#.#...#...#.#
#.#####.#.#.#.#.#.#.#.#####.#.#.#.#.###.#
#.#...#...#.#...#...#.....#.#.#.#.#...#.#
#.#.#.###.#.#.###########.#.#.#.#.###.#.#
#.#.#.....#.#.#...........#.#.#.#.#0#...#
#.#.#######.###.###########.#.#.#.#.#####
#.#.#.....#...#.#.#.........#.#.#.#.....#
#.#.###.#.###.#.#.#.#.#######.#.#.#####.#
#.......#...#...#...#...........#.......#
#########################################
